agitation	agitation
bradycardia	bradycardia
combative	combative
constipation	constipation
cough	cough
diaphoresis	diaphoresis
distention	distension
lightheadedness	lightheadedness
hyperglycemia	hyperglycemia
hypertension	hypertension
hyperthermia	hyperthermia
hypoglycemia	hypoglycemia
incontinence	incontinence
malaise	malaise
myalgia	myalgias
nausea	nausea
pregnancy	pregnancy
drowsiness	sleepiness
somnolence	sleepiness
trauma	trauma
violent	violent
vomiting	vomiting
weakness	weakness
wheezing	wheezing
sob	shortness of breath
throb	pulses
restlessness	agitation
turmoil	agitation
unrest	agitation
obstipation	constipation
diminish	decreased
cluster headache	headache
sinus headache	headache
tension headache	headache
essential hypertension	hypertension
malignant hypertension	hypertension
secondary hypertension	hypertension
urinary incontinence	incontinence
awareness	consciousness
morning sickness	nausea
motion sickness	nausea
ectopic pregnancy	pregnancy
miliaria	rash
urticaria	rash
hematemesis	vomiting
syncope	loss of consciousness
delusion	hallucinations
sternness	severity
dyspnea	shortness of breath
