abdominal	abdominal
abdominal muscle	abdominal
ab	abdominal
pain	pain
hurting	pain
painfulness	pain
pain sensation	pain
painful sensation	pain
absent	absent
remove	absent
lacking	absent
missing	absent
wanting	absent
scatty	absent
pulsation	pulses
pulsing	pulses
pulse	pulses
impulse	pulses
heartbeat	pulses
beat	pulses
pulse rate	pulses
heart rate	pulses
pulsate	pulses
throb	pulses
agitate	agitated
foment	agitated
stir up	agitated
rouse	agitated
turn on	agitated
charge	agitated
commove	agitated
excite	agitated
charge up	agitated
crusade	agitated
fight	agitated
press	agitated
campaign	agitated
push	agitated
stir	agitated
shift	changes
budge	agitated
shake	agitated
vex	agitated
disturb	agitated
shake up	agitated
raise up	agitated
agitated	agitated
craze	delirium
delirium	delirium
frenzy	delirium
fury	delirium
hysteria	delirium
agitation	agitation
ferment	agitation
fermentation	agitation
tempestuousness	agitation
unrest	agitation
excitement	agitation
turmoil	agitation
upheaval	agitation
hullabaloo	agitation
baseline	baseline
service line	baseline
neurological	neurological
neurologic	neurological
status	status
position	status
condition	status
bizarre	bizarre
eccentric	bizarre
freakish	bizarre
freaky	bizarre
flaky	bizarre
flakey	bizarre
gonzo	bizarre
off-the-wall	bizarre
outlandish	bizarre
outre	bizarre
behavior	behavior
behaviour	behavior
conduct	behavior
doings	behavior
demeanor	behavior
demeanour	behavior
deportment	behavior
blindness	blindness
sightlessness	blindness
cecity	blindness
bradycardia	bradycardia
thorax	chest
chest	chest
pectus	chest
breast	chest
stringency	tightness
tightness	tightness
constriction	tightness
concentration	tightness
density	tightness
denseness	tightness
compactness	tightness
clammy	clammy
dank	clammy
skin	skin
tegument	skin
cutis	skin
hide	skin
pelt	skin
peel	skin
clamber	skin
contentious	combative
combative	combative
disputatious	combative
disputative	combative
litigious	combative
agonistic	combative
agonistical	combative
battleful	combative
bellicose	combative
confusion	confusion
mental confusion	confusion
confusedness	confusion
muddiness	confusion
disarray	confusion
discombobulation	confusion
mix-up	confusion
constipation	constipation
irregularity	constipation
paroxysm	convulsions
fit	convulsions
convulsion	convulsions
cool	cool
chill	cool
cough	cough
coughing	cough
decrease	decreased
diminish	decreased
lessen	decreased
fall	decreased
minify	decreased
decreased	decreased
reduced	decreased
mental	mental
genial	mental
ocular	visual
optic	visual
optical	visual
visual	visual
acuity	acuity
visual acuity	acuity
sharp-sightedness	acuity
acuteness	acuity
sharpness	acuity
keenness	acuity
idea	thought
thought	thought
thinking	thought
thought process	thought
cerebration	thought
intellection	thought
mentation	thought
opinion	thought
sentiment	thought
persuasion	thought
view	thought
perspiration	diaphoresis
sweating	diaphoresis
diaphoresis	diaphoresis
sudation	diaphoresis
hidrosis	diaphoresis
diarrhea	diarrhea
diarrhoea	diarrhea
looseness of the bowels	diarrhea
looseness	diarrhea
distention	distension
distension	distension
dilatation	distension
dizziness	lightheadedness
giddiness	lightheadedness
lightheadedness	lightheadedness
vertigo	lightheadedness
fever	fever
febrility	fever
febricity	fever
pyrexia	fever
feverishness	fever
hallucination	hallucinations
delusion	hallucinations
headache	headache
vexation	headache
head ache	headache
cephalalgia	headache
homicidal	homicidal
murderous	homicidal
hyperglycemia	hyperglycemia
hyperglycaemia	hyperglycemia
high blood pressure	hypertension
hypertension	hypertension
hyperthermia	hyperthermia
hyperthermy	hyperthermia
hypoglycemia	hypoglycemia
hypoglycaemia	hypoglycemia
incontinence	incontinence
incontinency	incontinence
know	known
cognize	known
cognise	known
experience	known
live	known
acknowledge	known
recognize	known
recognise	known
well	well
wellspring	well
fountainhead	well
swell	well
good	well
easily	well
considerably	well
substantially	well
intimately	well
advantageously	well
comfortably	well
loss	loss
deprivation	loss
personnel casualty	loss
passing	loss
departure	loss
exit	loss
expiration	loss
going	loss
release	discharge
consciousness	consciousness
awareness	consciousness
cognizance	consciousness
cognisance	consciousness
knowingness	consciousness
malaise	malaise
unease	malaise
uneasiness	malaise
change	changes
alteration	changes
modification	changes
variety	changes
alter	changes
modify	changes
vary	changes
switch	changes
convert	changes
interchange	changes
transfer	changes
deepen	changes
myalgia	myalgias
myodynia	myalgias
nausea	nausea
sickness	nausea
radiation	radiation
radiation sickness	radiation
region	region
part	region
area	region
neighborhood	region
realm	region
badness	severity
severity	severity
severeness	severity
asperity	severity
grimness	severity
hardship	severity
rigor	severity
rigour	severity
rigorousness	severity
rigourousness	severity
austereness	severity
harshness	severity
inclemency	severity
hardness	severity
stiffness	severity
picket	pale
pale	pale
blanch	pale
blench	pale
pallid	pale
wan	pale
sick	vomiting
palpitation	palpitations
shaking	palpitations
shakiness	palpitations
trembling	palpitations
quiver	palpitations
quivering	palpitations
vibration	palpitations
gear	paraphernalia
paraphernalia	paraphernalia
appurtenance	accessory
point	point
detail	point
item	point
degree	point
level	point
stage	point
point in time	point
tip	point
peak	point
dot	point
spot	point
compass point	point
period	point
full stop	point
stop	point
full point	point
ictal	ictal
ictic	ictal
pregnancy	pregnancy
gestation	pregnancy
maternity	pregnancy
rattle	rales
rattling	rales
rale	rales
rash	rash
roseola	rash
efflorescence	rash
skin rash	rash
recoil	rebound
repercussion	rebound
rebound	rebound
backlash	rebound
bounce	rebound
resile	rebound
take a hop	rebound
spring	rebound
bound	rebound
reverberate	rebound
ricochet	rebound
rally	rebound
tenderness	tenderness
soreness	tenderness
rawness	tenderness
rhonchus	rhonchi
rigidity	rigidity
rigidness	rigidity
inflexibility	rigidity
seizure	seizure
ictus	seizure
raptus	seizure
capture	seizure
gaining control	seizure
shortness	shortness
truncation	shortness
abruptness	shortness
brusqueness	shortness
curtness	shortness
gruffness	shortness
breath	breath
breather	breath
breathing place	breath
sleepiness	sleepiness
drowsiness	sleepiness
somnolence	sleepiness
history	history
account	history
chronicle	history
story	history
self-destructive	suicidal
suicidal	suicidal
think	thought
believe	thought
consider	thought
conceive	thought
opine	thought
suppose	thought
imagine	thought
reckon	thought
guess	thought
cogitate	thought
cerebrate	thought
remember	thought
retrieve	thought
recall	thought
call back	thought
call up	thought
recollect	thought
intend	thought
mean	thought
injury	trauma
hurt	trauma
harm	trauma
trauma	trauma
psychic trauma	trauma
unequal	unequal
inadequate	unequal
use	use
usage	use
utilization	use
utilisation	use
employment	use
exercise	use
function	use
purpose	use
role	use
consumption	use
economic consumption	use
usance	use
utilize	use
utilise	use
apply	use
employ	use
habituate	use
expend	use
practice	use
accessory	accessory
accoutrement	accessory
accouterment	accessory
supplement	accessory
add-on	accessory
accessary	accessory
adjunct	accessory
ancillary	accessory
adjuvant	accessory
appurtenant	accessory
auxiliary	accessory
muscle	muscles
musculus	muscles
muscular tissue	muscles
muscleman	muscles
bleeding	bleeding
hemorrhage	bleeding
haemorrhage	bleeding
shed blood	bleeding
bleed	bleeding
leech	bleeding
phlebotomize	bleeding
phlebotomise	bleeding
discharge	discharge
venting	discharge
emission	discharge
expelling	discharge
outpouring	discharge
run	discharge
dismissal	discharge
dismission	discharge
firing	discharge
liberation	discharge
sack	discharge
sacking	discharge
waiver	discharge
drop	discharge
drop off	discharge
violent	violent
wild	violent
fierce	violent
tearing	violent
vehement	violent
vomit	vomiting
vomiting	vomiting
emesis	vomiting
regurgitation	vomiting
disgorgement	vomiting
puking	vomiting
vomit up	vomiting
purge	vomiting
cast	vomiting
cat	vomiting
be sick	vomiting
disgorge	vomiting
regorge	vomiting
retch	vomiting
puke	vomiting
barf	vomiting
spew	vomiting
spue	vomiting
chuck	vomiting
upchuck	vomiting
honk	vomiting
regurgitate	vomiting
throw up	vomiting
failing	weakness
weakness	weakness
helplessness	weakness
impuissance	weakness
wheeze	wheezing
asthmatic	wheezing
wheezing	wheezing
wheezy	wheezing
shortness of breath	shortness of breath
sob	shortness of breath
breathlessness	shortness of breath
