trauma	trauma
wound	wound
cough	cough
abrasion	abrasion
respiration	ventilation
ventilation	ventilation
alert	alert
reaction	reaction
amiodarone	amiodarone
hemorrhage	bleeding
breath	breath
burn	burn
burning	burn
shock	shock
chemical	chemical
collision	collisions
contusion	contusion
deformity	deformity
distress	distress
dizziness	dizziness
giddiness	dizziness
vertigo	dizziness
electrocardiography	electrocardiography
extrication	extrication
furosemide	furosemide
hemodialysis	hemodialysis
urticaria	hives
hyperthermia	hyperthermia
inhalation	inhalation
ketoacidosis	ketoacidosis
vertebral column	spinal column
obstruction	obstruction
pulse rate	pulse rate
regular	regular
shivering	shivering
vomiting	vomiting
weakness	weakness
blood glucose	blood sugar
cardiopulmonary resuscitation	cardiopulmonary resuscitation
cerebrovascular accident	cerebrovascular accident
gag reflex	gag reflex
ipratropium bromide	ipratropium bromide
causalgia	pain
neuralgia	pain
nuisance	pain
pulmonary circulation	circulation
anaphylactic shock	anaphylaxis
sleep apnea	apnea
metrorrhagia	bleeding
epistaxis	bleeding
coughing	symptoms
diarrhea	symptoms
nausea	symptoms
sneezing	symptoms
tinnitus	symptoms
hypovolemic shock	shock
erythema multiforme	erythema
erythema nodosum	erythema
sunburn	erythema
anoxia	hypoxia
pruritus	itching
awareness	consciousness
morning sickness	nausea
motion sickness	nausea
blockage	obstruction
obstacle	obstruction
intestinal obstruction	obstruction
commotion	disturbance
disruption	disturbance
perturbation	disturbance
upset	disturbance
intumescence	swelling
intumescency	swelling
rebound tenderness	tenderness
phytotoxin	toxin
ricin	toxin
hematemesis	vomiting
laceration	wound
ischemic stroke	cerebrovascular accident
pulse	vital signs
respiratory rate	vital signs
injury	wound
dialysis	hemodialysis
sternness	severity
dyspnea	shortness of breath
